100000000000000001
100000000000000001
100000000000000001
100000000000000001
100000000000000001
100000000000000001
100000000000000001
1000000CC0000C0001
10P0000000000000X1
111111100111111111
100000000000000001
1LLLLLLLLLLLLLLLL1