100000000000000001
100000000000000001
100000000000000001
100000000000000001
100000000000000001
100000000000000001
100000000000000001
100000CCC000C00C01
10P0000E00000000X1
111100111001100111
100000000000000001
1LLLLLLLLLLLLLLLL1