100000000000000001
100000000000000001
10P000000000000001
1111EE000000000001
1000111EE000000001
1000000111EE000001
1000000000111CC001
10000000000001CC01
100000000000000CC1
1000000000000000X1
100000000000000011
1LLLLLLLLLLLLLLLL1