100000000000000001
100000000000000001
10P00EEEEEE0000001
1111111111110000X1
100000000000001011
100000000000000001
100000000000100001
10CCCC000000000001
1XCCCC000000000001
111111000000000001
100000101000000001
1LLLLLLLLLLLLLLLL1