100000000000000001
100000000000000001
1000000P0000000001
100000010000000001
100000000000000001
100000000EE0000001
100000000EE0000001
100000000EE0000001
100000000000000001
1000000000X0000001
100000000010000001
1LLLLLLLLLLLLLLLL1